w,w,w,w,w,w,w,w,w,w,w,w,w,w,w,
w,g,p,p,p,p,p,p,p,p,p,p,p,g,w,
w,p,w,p,w,p,w,p,w,p,w,p,w,p,w,
w,k,p,p,w,p,w,p,w,p,w,p,p,k,w,
w,w,w,p,w,p,w,p,w,p,w,p,w,w,w,
w,w,w,p,w,p,w,u,w,p,w,p,w,w,w,
w,g,p,p,w,p,p,p,p,p,w,p,p,g,w,
w,p,w,p,w,w,w,p,w,w,w,p,w,p,w,
w,k,p,p,p,p,p,p,p,p,p,p,p,k,w,
w,w,w,w,w,w,w,w,w,w,w,w,w,w,w,
